
	139, 139, 139, 139, 139, 139, 139, 139, 143, 143, 143, 143, 143, 143, 143, 143, 
	143, 143, 143, 143, 139, 139, 139,   0,   0,   0,   0,   0, 132,   0,   0,   0, 

	145, 143, 143, 143, 143, 143, 143, 143, 133, 134,   0,   0,   0, 132,   0, 128, 
	  0,   0, 175,   0, 143, 143, 143, 139, 139,   0,   0,   0,   0, 167, 169,   0, 

	145,   0,   0,   0,   0,   0, 132,   0,   0,   0,   0,   0,   0, 151,   0, 153, 
	  0,   0, 179, 181,   0,   0,   0, 143, 145,   0, 132,   0,   0, 171, 174,   0, 

	145,   0, 128,   0, 159, 161,   0,   0,   0, 128,   0,   0,   0, 147, 148, 149, 
	  0,   0,   0,   0, 159, 161,   0,   0, 145,   0,   0,   0,   0,   0, 138,   0, 

	145,   0, 132,   0, 163, 166,   0,   0,   0,   0,   0, 159, 161,   0,   0,   0, 
	  0,   0,   0, 181, 163, 166, 131,   0, 145, 128,   0, 129,   0, 134,   0,   0, 

	145,   0,   0, 129,   0, 138,   0,   0, 134,   0,   0, 163, 166,   0,   0, 132, 
	  0,   0,   0,   0,   0, 138,   0,   0, 145,   0,   0,   0,   0,   0,   0, 130, 

	145,   0,   0,   0,   0,   0,   0,   0,   0,   0,   0,   0, 138,   0,   0,   0, 
	  0, 132,   0,   0, 130,   0,   0,   0, 145,   0, 139,   0,   0,   0, 139,   0, 

	145,   0,   0, 159, 161,   0,   0,   0, 144,   0, 140,   0,   0,   0, 142,   0, 
	  0,   0,   0, 140,   0,   0,   0,   0, 145, 139, 141, 134, 144,   0, 141, 139, 

	145,   0,   0, 163, 166,   0,   0,   0,   0,   0,   0,   0,   0,   0, 134,   0, 
	144,   0,   0,   0,   0, 144,   0,   0, 143, 143, 143,   0, 138, 134, 143, 145, 

	145, 131,   0,   0, 138,   0,   0,   0, 134,   0, 159, 161,   0, 135,   0,   0, 
	  0,   0, 152,   0,   0,   0,   0, 142,   0,   0, 140,   0,   0,   0, 150, 145, 

	145,   0, 133,   0,   0,   0,   0, 138,   0, 135, 163, 166, 137,   0,   0,   0, 
	  0,   0,   0,   0, 129,   0,   0,   0,   0,   0,   0,   0,   0,   0,   0, 145, 

	145, 146, 146, 131,   0,   0,   0,   0,   0,   0,   0, 138,   0,   0,   0,   0, 
	138,   0,   0, 142,   0,   0,   0,   0, 136, 136, 136, 136, 136, 136, 136, 145, 

	145, 139, 139, 139, 139,   0,   0, 142,   0,   0,   0,   0,   0,   0,   0,   0, 
	  0,   0,   0,   0,   0,   0,   0,   0, 136, 136, 136, 154, 136, 136, 136, 145, 

	143, 143, 143, 143, 145,   0,   0,   0,   0,   0, 134,   0,   0, 139, 134,   0, 
	134, 139,   0,   0, 132, 133, 128,   0, 136, 136, 136, 136, 136, 136, 136, 145, 

	130, 155, 157, 128, 145, 139, 139, 139, 139, 139, 139, 139, 139, 141,   0, 144, 
	  0, 141, 139, 139, 139, 139, 139, 139, 139, 139, 139, 139, 139, 139, 139, 145, 

	  0, 128,   0, 132, 143, 143, 143, 143, 143, 143, 143, 143, 143, 143,   0, 138, 
	  0, 143, 143, 143, 143, 143, 143, 143, 143, 143, 143, 143, 143, 143, 143, 143, 
